0 0 0 0 0 0 0 0 0 0 0 0 0 0 0 0 0 0 0 0 0 0 0 0
0 0 0 0 0 0 0 0 0 0 0 0 0 0 0 0 0 0 0 0 0 0 0 0
0 0 0 0 0 1 10 15 3 26 1 11 20 18 35 36 19 11 24 26 8 0 0 0
0 0 0 0 0 2 11 16 16 18 17 31 2 36 29 11 30 33 23 9 17 0 0 0
0 0 0 0 0 3 10 17 4 13 28 32 31 8 34 5 15 6 14 28 32 0 0 0
0 0 0 0 0 4 2 18 14 5 29 25 17 15 12 7 23 28 30 7 14 0 0 0
0 0 0 0 0 5 9 19 3 22 30 21 33 24 7 18 27 27 13 26 6 0 0 0
0 0 0 0 0 6 12 20 12 7 30 18 18 5 35 21 15 25 2 20 23 0 0 0
0 0 0 0 0 7 13 1 23 27 4 33 3 35 12 33 24 31 16 21 32 0 0 0
0 0 0 0 0 8 6 21 24 22 1 34 29 29 20 8 25 22 32 16 31 0 0 0
0 0 0 0 0 9 14 22 25 9 26 35 34 13 36 34 4 27 7 36 28 0 0 0
0 0 0 0 0 0 0 0 0 0 0 0 0 0 0 0 0 0 0 0 0 0 0 0
0 0 0 0 0 0 0 0 0 0 0 0 0 0 0 0 0 0 0 0 0 0 0 0