0 0 0 0 0 0 0 0 0 0 0 0 0 0 0 0 0 0 0 0 0 0 0 0 
0 0 0 0 0 0 0 0 0 0 0 0 0 0 0 0 0 0 0 0 0 0 0 0 
0 0 0 0 0 36 27 22 34 11 36 26 17 19 2 1 18 26 13 11 29 0 0 0 
0 0 0 0 0 35 26 21 21 19 20 6 35 1 8 26 7 4 14 28 20 0 0 0 
0 0 0 0 0 34 27 20 33 24 9 5 6 29 3 32 22 31 23 9 5 0 0 0 
0 0 0 0 0 33 35 19 23 32 8 12 20 22 25 30 14 9 7 30 23 0 0 0 
0 0 0 0 0 32 28 18 34 15 7 16 4 13 30 19 10 10 24 11 31 0 0 0 
0 0 0 0 0 31 25 17 25 30 7 19 19 32 2 16 22 12 35 17 14 0 0 0 
0 0 0 0 0 30 24 36 14 10 33 4 34 2 25 4 13 6 21 16 5 0 0 0 
0 0 0 0 0 29 31 16 13 15 36 3 8 8 17 29 12 15 5 21 6 0 0 0 
0 0 0 0 0 28 23 15 12 28 11 2 3 24 1 3 33 10 30 1 9 0 0 0 
0 0 0 0 0 0 0 0 0 0 0 0 0 0 0 0 0 0 0 0 0 0 0 0 
0 0 0 0 0 0 0 0 0 0 0 0 0 0 0 0 0 0 0 0 0 0 0 0 
